SO         ./src/textures/Wall7.xpm
WE ./src/textures/Wall4.xpm
NO ./src/textures/Wall2.xpm
EA ./src/textures/Wall8.xpm

C                                   0,0,0
F 220,100,0


10000000000001
10000000000001
      10000000000001111126
100000000000011111111111111
1N000000000001
1000000000000111
1            1
10000000000001
10000000000001
10000000000001
11111111111111

