NO ./src/textures/Wall2.xpm
WE ./src/textures/Wall4.xpm






F 123,     25        ,        0000000123

SO ./src/textures/Wall7.xpm




C 123 , 00100, 0000025
		EA 			./src/textures/Wall8.xpm







		            111111111111111
		            1000000000000001
		            10000000E000001
		            1000000000000001
		111111111111100000000000001
		1000000000000001111111111111
		1111111111111111
		1111111111s11111
		100000000000000111111111111111111111
		1000011111110001
		100011  11001111
		1000011111110001             11
		10000000000000011111111111111001
		11111111011111111            11
		1111111101111111111111111111111111111
		1000000000000001         100000000001
		1111111111111111         111111111111
		1111111111111111         111111111111
		1000000000000001         100000000001
		1000000000000001         100000100001
		1000000000000001         10000000011
		1000000000000001         100000000001
		1111111111111111         111111111111

