NO ./src/textures/Wall2.xpm
WE ./src/textures/Wall4.xpm
F 123, 123, 123
		EA 			./src/textures/Wall8.xpm
SO ./src/textures/Wall7.xpm

C 123, 23, 100

1111111111111111111111111
1000100000110000000001001
1111111110110000111000001
        10010000000000001
1111111110110000011100001
1000000000110000N11101111
1111011111111101110000001
1111111111111111111111111
