NO ./textures/simple/north.xpm
WE ./textures/simple/west.xpm






F 0,0,0
SO ./textures/simple/south.xpm




C 0,0,      0
		EA 			./textures/simple/east.xpm



111111111111111111111111111111111111111111111111111111111111111111111
10111011010111111111111111111110000000000000000000000000000000001111111
1111110111111111110110100000000000000100000000000000001010100000000000011
11110101         111111111111111111000000000000000000000000000001111111111
101010111        100101011111111111111111111111111000000000000000011111111
11000110111111111101010001111111111111111111111111100000000000000001111111
100000000000000000000000000000000000000000000000000000000000000000000001111
100000000000000000000000000000000000000000000000000000000000010111111111111
100001111111010000000000000000000000000000000000000000000000000000000000111
100001111111010000000000000000000000000000000000000000000000000000000000111
100001111111010000000000000000000000000000000000000000000000000000000000111
100001111111010000000000000000000000000000000000000000000000000000000000111
100001111111010000000000000000000000000000000000000000000000000000000000111
100001111111010000000000000000000000000000000000000000000000000000000000111
100001111111010000000000000000000000000000000000000000000000000000000000111
100001111111010000000000000000000000000000000000000000000000000000000000111
10000111111101000000000000000000000000000000E000000000000000000000000000111
100001111111010000000000000000000000000000000000000000000000000000000000111
100001111111010000000000000000000000000000000000000000000000000000000000111
100001111111010000000000000000000000000000000000000000000000000000000000111
100001111111010000000000000000000000000000000000000000000000000000000000111
100001111111010000000000000000000000000000000000000000000000000000000000111
100001111111010000000000000000000000000000000000000000000000000000000000111
100001111111010000000000000000000000000000000000000000000000000000000000111
100001111111010000000000000000000000000000000000000000000000000000000000111
110111001111101000000000000000000000000000000000000000000000000000000000001
111111111111111111111111111111111111111111111111111111111111111111111111111
